11111111111111111111
10000000000000000001
10110111101111011001
10000C0000C00000C001
10110111101111011001
10000000000000000001
11011110111101111011
10C0000P000P000C0001
11011110111101111011
11111111111111111111
10110111101111011001
10C0000000E0000000C1
11111111111111111111